#####
#@$.#
#####
;
###
#.###
#*$ #
# @ #
#####
;
#######
#.@ # #
#$* $ #
#   $ #
# ..  #
#  *  #
#######
;
 #####
 #   ####
 #   #  #
 ##    .#
### ###.#
# $ # #.#
# $$# ###
#@  #
#####
;
 #######
 #     #
 # .$. #
## $@$ #
#  .$. #
#      #
########
;
###### #####
#    ###   #
# $$     #@#
# $ #...   #
#   ########
#####
;
#######
#     #
# .$. #
# $.$ #
# .$. #
# $.$ #
#  @  #
#######
;
  #####
###   #
# $ # ##
# #  . #
#    # #
## #   #
 #@  ###
 #####
;
  #####
###   #
# $ # ##
# #  . #
#    # #
##$#.  #
 #@  ###
 #####
;
    ####
#####  #
#   $  #
#  .#  #
## ## ##
#      #
# @#   #
#  #####
####
;
  #####
###   #
# $ # ##
# #  . #
# .  # #
##$#.$ #
 #@  ###
 #####
;
   ###
  ## # ####
 ##  ###  #
## $      #
#   @$ #  #
### $###  #
  #  #..  #
 ## ##.# ##
 #      ##
 #     ##
 #######
;
 ## #####
## ## . #
# ## $. #
 ## $   #
## $@ ###
# $  ##
#.. ## ##
#   # ##
##### #
;
  ###########
 ##     #  @#
### $ $$#   #
# ##$    $$ #
#  #  $ #   #
###### ######
#.. ..$ #*##
# ..    ###
#  ..#####
#########
;   
#######
 ###     ##
 #   ###  #
 #      # #
###$#@  # #
#   ##### #
#   #  *. #
##$$#  *.##
 #     *..#
 #### #...##
    # #$$$ #
    #   $  #
    #####  #
        ####
;
 #######
##     # #
#  *.$.#
#  *.#.###
# #$@$$  #
#   ## # #
######   #
     #####
;
   ####
   #@ #
  ##  ##
  # .$#####
  #$. #   #
###..$# # #
#  ..$  $ #
# $ $ # ###
##### # #
    #   #
    ###.#
      ###