#####
#@$.#
#####
;
#######
#.@ # #
#$* $ #
#   $ #
# ..  #
#  *  #
#######
;
###
#.###
#*$ #
# @ #
#####